2222222222222222222222222222222222222222222222222222222222222222222222222222222222212111122
2222222222222222222222222222222222222222222222222222222222222222221221111111111111111111122
2222222222222222222222222222222222221211111111222222222222222222222110111111111110000001022
2222222222122222222221111111111111111111111011222222211111111111111111110000000000000001122
2211111111111111222111111111111110000000000001111111111111111000000000000000000000000001112
2111111111111111112011000000000000000000000001111111000000000000000000000000000000000001112
2111111110000000011010000000000000000000000001110000000000000000000000000000000000000001112
2110000000000000001011000000000000000000000001110000000000000000000000000000000000000001112
2210000000000000001011000000000000000000000001110000000000000000000000000000000000000001112
2110000000000000001011000000000000000000000001110000000000000000000000000000000000000001112
2110000000000000001111000000000000000000000001110000000000000000000000000000000000000000112
2210000000000000001111000000000000000000000001110000000000000000000000000000000000000000112
2211000000000000001110000000000000000000000001110000000000000000000000000000000000000000112
2211000000000000000000000000000000000000000001111000000000000000000000000000000000000000112
2211000000000000000000000000000000000000000000111000000000000000000000000000000000000000112
2211000000000000000000000000000000000000000001111000000000000000000000000000000000000000112
2211000000000000000000000000000000000000000000111000000000000000000000000000001100000000112
2211000000000000000000000000000000000001111111111000000000000000000111111111111110000000112
2211000000000000000000000000000001111111222222221000000011111111111111111111111210000000112
2211000000000000000000000000000001122222122222111111111111111111111111111111011211000000012
2211000000000000000000000000000001111111111111111111111100000000000000000000011211000000012
2211000000000000000000000000000001111110000000000000000000000000000000000000011111000000012
2211000000000000000000000000000000000000000000000000000000000000000000000000011211000000012
2211100000000000000000000000000000000000000000000000000000000000000000000000011211000000011
2221100000000000000000000000000000000000000000000000000000000000000000000000001111000000011
2221100000000000000000000000000000000000000000000000000000000000000000000000001110000000011
2221100000000000000000000000000000000000000000000000000000000000000000000000000000000000011
2221100000000000000000000000000000000000000000000000000000000000000000000000000000000000011
2221100000000000000000000000000000000000000000000000000000000000000000000000000000000000011
2221100000000000000111000000000000000000000000000000000000000000000000000000000000000000011
2221100000000000000111000000000000000000000000000000000000000000000000000000000000000000011
2221100000000000000111000000000000000000000000000000000000000000000000000000000000000000011
2221100000000000000111000000000000000000000000000000000000000000000000000000000000000000011
2221100000000000000111000000000000000000000000000000000000000000000000000000000000000000001
2221110000000000000111000000000000000000000000000000000000000000000000000000000000000000001
2221110000000000000111000000000000000000000000000000000000000000000000000000000000000000001
2222110000000000000111000000000000000000000000000000000000000000000000000000000000000000001
2222110000000000011111000000000000000000000000000000000000000000000000000000000000000000001
2222111111111111111111000000000000000000000000000000000000000000000000000000000000000000001
2222111111121111211011000000000000000000000000000000000000000000000000000000000000000000001
2222111111111111111111000000000000000000000000000000000000000000000000000000000000000000001
2221111111111000000000000000000000000000000000000000000000000000000000000000000000000000001
2221100000000000000000000000000000000000000000001111000000000000000000000000000000000000001
2221100000000000000000000000000000000000000000001111000000000000000000000000000000000000001
2221100000000000000000000000000000000000000000001111000000000000000000000000000000000000001
2221110000000000000000000000000000000000000000001111000000000000000000000000000000000000001
2222100000000000000000000000000000000000000000001111000000000000000000000000000000000000001
2222100000000000000000000000000000000000000000001111000000000000000000000000000000000000001
2222110000000000000000000000000000000000000000001111000000000000000000000000000000000000001
2222100000000000000000000000000000000000000000001111000000000000000000000000000000000000001
2222110000000000000000000000000000000000000000001111000000000000000000000000000000000000001
2222110000000000000000000000000000000000000000000111000000000000000000000000000000000000001
2222110000000000000000000000000000000000000000000111000000000000000000000000000000000101111
2222110000000000000000000000000000000000000000000111000000000000111111111111111111111111111
2222110000000000000000000000000000000000000000000111111111111111111111111111110111111111222
2222110000000000000000000000000000000000000000000111111212222222222222222222211222222222222
2222110000000000000000000000000000000000000000000111222222222222222222222222222222222222222
2222110000000000000000000000000000000000000000000101122222222222222222222222222222222222222
2222110000000000000000000000000000000000000000000111222222222222222222222222222222222222222
2222110000000000000000000000000000000011111111111112222222222222222222222222222222222222222
2222210000000000000000000000000111111111111111112222222222222222222222222222222222222222222
2222110000000000000000000000000101212222222222222222222222222222222222222222222222222222222
2222210000000000000000000000000102222222222222222222222222222222222222222222222222222222222
2222210000000000000000000000000100111111111111111112222222222222222222222222222222222222222
2222210000000000000000000000000100111111101000000112222222222222222222222222222222222222222
2222210000000000000000000000000111100000000000000112222222222222222222222222222222222222222
2222210000000000000000000000000110110000000000000012222222222222222222222222222222222222222
2222211000000000000000000000000111110000000000000012222222222222222222222222222222222222222
2222211000000000000000000000000110110000000000000012222222222222222222222222222222222222222
2222211000000000000000000000000111110000000000000012222222222222222222222222222222222222222
2222211000000000000000000000000111110000000000000012222222222222222222222222222222222222222
2222211000000000000000000000000011100000000000000011222222222222222222222222222222222222222
2222211000000000000000000000000000000000000000000011222222222222222222222222222222222222222
2222211000000000000000000000000000000000000000000011222222222222222222222222222222222222222
2222211000000000000000000000000000000000000000000011222222222222222222222222222222222222222
2222211000000000000000000000000000000000000000000011222222222222222222222222222222222222222
2222211000000000001111000000000000000000000000000011222222222222222222222222222222222222222
2222210000000000011011000000000000000000000000000011222222222222222222222222222222222222222
2222210000000000011211000000000000000000000000000011222222222222222222222222222222222222222
2222210000000000011221000000000000000000000000000011222222222222222222222222222222222222222
2222210000000000011221000000000000000000000000000011222222222222222222222222222222222222222
2222210000000000011021000000000000000000000000000011222222222222222222222222222222222222222
2222210000000000011121000000000000000000000000000011222222222222222222222222222222222222222
2222210000000000011121000000000000000000000000000011222222222222222222222222222222222222222
2222210000000000011121000000000000000000000000000011222222222222222222222222222222222222222
2222210000000000011121000000000000000000000000000011222222222222222222222222222222222222222
2222210000000000010021000000000000000000000000000011222222222222222222222222222222222222222
2222210000000000010121000000000000000000010001111111222222222222222222222222222222222222222
2222210000000000011121111111111111111111111111111111222222222222222222222222222222222222222
2222211111111111111221111111111211112222222222222222222222222222222222222222222222222222222
2222222111112222222222222222222222222222222222222222222222222222222222222222222222222222222
